NO ./texture/north.png    
SO./texture/south.png
WE./texture/west.png
EA./texture/east.png

F 254,100,0
C 225,30,0

11111
1N001
111